WWWWWWWWWWWWWWWWWWWWWWWWWWWWWW
W                     W      W
T                            T
T                     W      T
T      G                     T
T                  W W W W   T
T      G                     T
T                 G          T
T      G                     T
T                 G          T
T                            T
W                 G          W
WWWWWWWWWWWWWWWWWWWWWWWWWWWWWW
