WWWWWWWWWWWWWWWWWWWWWWWWWWWWWW
W                     W      W
T                     W      T
T                     W      T
T      G              W      T
T      G           WW W WW   T
T      G                     T
T                 G          T
T                 G          T
T                 G          T
T                            T
W                            W
WWWWWWWWWWWWWWWWWWWWWWWWWWWWWW
