WWWWWWWWWWWWWWWWWWWWWWWWWWWWWW
W                            W
T                            T
T                            T
T      G                     T
T      G                     T
T      G                     T
T                            T
T  WWWW              WWWW    T
T  W                    W    T
T  W                    W    T
W  W                    W    W
WWWWWWWWWWWWWWWWWWWWWWWWWWWWWW
